AAA = "countries/AAA - Omas City.txt"
AAB = "countries/AAB - Crushers.txt"
AAD = "countries/AAD - New Ontario.txt"
AAE = "countries/AAE - canadianenclave.txt"
AAF = "countries/AAF - Wolf Brotherhood.txt"
AAG = "countries/AAG - Victoria.txt"
AAI = "countries/AAI - Otta City.txt"
AAJ = "countries/AAJ - Canadian Brotherhood.txt"
AAQ = "countries/AAQ - Anishinaabe.txt"
AUA = "countries/AUA - bigcity.txt"
AUB = "countries/AUB - raidersdetki.txt"
AUC = "countries/AUC - supmutlitllamp.txt"
BAA = "countries/BAA - Montreal.txt"
BAG = "countries/BAG - bagInstitute.txt"
BAS = "countries/BAS - Billsylvania.txt"
BOK = "countries/BOK - Boksers.txt"
BSM = "countries/BSM - Bostonskiesupermutanti.txt"
BSS = "countries/BSS - Brotherss.txt"
BUF = "countries/BUF - Bufalo.txt"
DAD = "countries/DAD - Enclavechicago.txt"
DAT = "countries/DAT - detiatomssodruj.txt"
DIA = "countries/DIA - Daymondcity.txt"
DEE = "countries/DEE - Delavere.txt"
DET = "countries/DET - detroit.txt"
DEV = "countries/DEV - Deyvi.txt"
DIK = "countries/DIK - dikari.txt"
DJA = "countries/DJA - Djared.txt"
DOB = "countries/DOB - dobrososedstvo.txt"
DRU = "countries/DRU - druids.txt"
DUB = "countries/DUB - derevya.txt"
ENY = "countries/ENY - Enclavenewyork.txt"
ESC = "countries/ESC - escante.txt"
ESP = "countries/ESP - Enclavepustashey.txt"
GUA = "countries/GUA - guanta.txt"
GUR = "countries/GUR - guronludoedi.txt"
IBS = "countries/IBS - izgoibratstva.txt"
INS = "countries/INS - Institute.txt"
IRO = "countries/IRO - Iroceso.txt"
IST = "countries/IST - Iston.txt"
KEN = "countries/KEN - Kenntuki.txt"
KLI = "countries/KLI - klivlend.txt"
KOV = "countries/KOV - Kovanie.txt"
KRO = "countries/KRO - Krokers.txt"
LIT = "countries/LIT - litldeti.txt"
MAM = "countries/MAM - mamadolche.txt"
MEN = "countries/MEN - Minitmens.txt"
MIN = "countries/MIN - mingocrik.txt"
MUT = "countries/MUT - mutanti.txt"
NBS = "countries/NBS - Newyorkbrother.txt"
NUE = "countries/NUE - York.txt"
PBU = "countries/PBU - pittVault.txt"
PIT = "countries/PIT - pitband.txt"
POI = "countries/POI - pointlokautdikar.txt"
RAB = "countries/RAB - rabotorg.txt"
RAR = "countries/RAR - Rangersreyly.txt"
REC = "countries/REC - Rechnoynorod.txt"
RIJ = "countries/RIJ - Turet.txt"
RIV = "countries/RIV - River.txt"
RON = "countries/RON - ronto.txt"
ROY = "countries/ROY - filips.txt"
RSD = "countries/RSD - sodrujestvareideri.txt"
SAY = "countries/SAY - Saymoncity.txt"
SBS = "countries/SBS - Stolbrother.txt"
SEV = "countries/SEV - Severniereyderi.txt"
SHE = "countries/SHE - Shenly.txt"
SLP = "countries/SLP - svobod.txt"
SOV = "countries/SOV - sovetinfallout.txt"
SPP = "countries/SPP - supmutpitsburga.txt"
STR = "countries/STR - strelki.txt"
TEN = "countries/TEN - Tenpenitauer.txt"
UBS = "countries/UBS - UjnayaBandapustoshey.txt"
USD = "countries/USD - ubejishesodrijestva.txt"
USP = "countries/USP - Vaultstalichpushtashi.txt"
VSU = "countries/VSU - Washingtonsupermut.txt"
